WWWWWWWWWWWWWWWWWWWWWWWWWWWWWWWWWWWWWWWW
WSSSSSSWSSSSSSBBBBBBBBBBBWSSSSSSSSSSSSSW
WSSSSSSWSfimSSBSSSSSSSSSSDSrimSSSSSSSSSW
WSSSSSSWSSSSSSBSSSGSSSSSSWSPSSSSSSSSSSSW
WSSSSSSWSkSSSSBSSSGSSSSSSWSSSSSSSSSSSSSW
WSSSSSWFSSSSSSBGGGGSSSSSSWSWSSSSSSSWSSSW
WSSSSSSWSSSSSSBSSSSSSSSSSWSWWWWWWWSWSSSW
WSSSSSSWSSSSSSBSSSSSSSSSSWSpiySSSSSWSSSW
WSSSSSSWSSWSSSBSSSSSSSSSSWSWWWWWiWWWSSSW
WSSSSSSWpiySSSBSSSSSSSSSSWSWSWSSRSSWSSSW
WSfioSSWWWWWWWBSSSSSSSSSSWSSSWSSWSSWSSSW
WSSSSSSSSSkSSWBSSSSSSSSSSWSSSWSSSSSWSSSW
WSSSSSSKSSiSSWBSSSSSSSSSSWSSSWSSSSSWSSSW
WSSSSSSSSSvSSWBSSSSSSSSSSWSSSWSSoSSWSSSW
WWWWWWWWWWWWWWBSSSSSSSSSSWSSSWWSSSSWSSSW
WSSSSSSSSSSSSWBSSSSSSSSSSWSSSWdisWSWSSSW
WSSSSSSSSSSSSWBSSSSSSSSSSWSSSWWWWWWWSSSW
WSSSSSSSSSSSSWBSSSSSSSSSSWSSSSSSSSSSSSSW
WSSSSSSSSSSSSWBSSSSSSSSSSWSSSSSSSSSSSSSW
WSSSSSSSSSSSSWBSbioSSSSSSWSSSSSSSSSSSSSW
WSSSSSSSSSSSSWBSSSSSSSSSSWSSSSSSSSSSSSSW
WSSSSSSSSSSSSWBSSSSSSSSSWWSSSSSSSSSSSSSW
WSSSSSSSSSSSSWBSSSSSSSgimWSSSSSSSSSSSSSW
WSSSSSSSSSSSSWBBBBBBBBBBBWSSSSSSSSSSSSSW
WWWWWWWWWWWWWWWWWWWWWWWWWWWWWWWWWWWWWWWW